{
	"case" : {
		"rows" : [
			"#######",
			"#.....#",
			"#.###.#",
			"#.###.#",			
			"#.###.#",
			"#.....#",
			"#######"
		],
		
		"tier" : 1
	},
	
	"next name": {
	
	}
}